{
    "Size": 8,
    "WorldMatrix": [
        [".", ".", ".", ".", ".", ".", ".", "."],
        [".", ".", ".", ".", ".", "W", ".", "."],
        [".", "G", ".", ".", ".", ".", ".", "."],
        [".", ".", ".", "W", ".", "W", ".", "."],
        [".", ".", ".", ".", ".", ".", ".", "."],
        [".", ".", "P", ".", ".", ".", "P", "."],
        [".", ".", ".", ".", ".", ".", ".", "."],
        [".", ".", ".", ".", ".", ".", ".", "."]
    ],
    "MovingWumpusMode": false
}