{
    "Size": 10,
    "WorldMatrix": [[".", ".", ".", ".", ".", "P", ".", ".", ".", "."],
                    [".", "W", ".", ".", ".", ".", ".", ".", "W", "."],
                    [".", ".", ".", ".", ".", ".", ".", ".", ".", "."],
                    [".", ".", ".", "G", ".", ".", ".", ".", ".", "."],
                    [".", ".", "P", ".", ".", ".", ".", ".", "P", "."],
                    [".", ".", ".", ".", ".", ".", ".", ".", ".", "."],
                    [".", ".", ".", ".", ".", ".", "W", ".", ".", "."],
                    [".", ".", ".", "P", ".", ".", ".", ".", ".", "."],
                    [".", ".", ".", ".", ".", ".", ".", ".", ".", "."],
                    [".", ".", ".", ".", "P", ".", ".", ".", "P", "."]
                   ],
    "MovingWumpusMode": false
}