{
    "Size": 15,
    "WorldMatrix": [[".", ".", ".", "P", ".", ".", ".", ".", ".", ".", "P", ".", ".", ".", "P"],
                    [".", ".", ".", ".", ".", ".", ".", ".", ".", ".", ".", ".", ".", ".", "."],
                    [".", ".", ".", ".", ".", ".", ".", ".", ".", ".", ".", ".", "W", ".", "."],
                    ["P", ".", "W", ".", ".", ".", "P", ".", ".", ".", "P", ".", ".", ".", "."],
                    [".", ".", ".", ".", ".", ".", ".", ".", ".", ".", ".", ".", ".", ".", "."],
                    [".", ".", ".", ".", ".", ".", ".", ".", ".", ".", ".", ".", ".", ".", "."],
                    [".", ".", ".", ".", ".", ".", ".", "G", ".", ".", ".", "P", ".", ".", "."],
                    [".", ".", ".", "P", ".", ".", ".", ".", ".", ".", ".", ".", ".", ".", "P"],
                    [".", ".", ".", ".", ".", ".", ".", ".", ".", ".", ".", ".", ".", ".", "."],
                    [".", ".", ".", ".", ".", ".", ".", ".", ".", ".", ".", ".", ".", ".", "."],
                    ["P", ".", "P", ".", ".", ".", ".", ".", ".", ".", ".", ".", ".", ".", "."],
                    [".", ".", ".", ".", ".", "W", ".", ".", ".", ".", "W", ".", ".", ".", "."],
                    [".", ".", ".", ".", ".", ".", ".", ".", ".", ".", ".", ".", ".", ".", "."],
                    [".", ".", ".", ".", ".", ".", ".", ".", "P", ".", ".", ".", "P", ".", "."],
                    [".", ".", ".", ".", ".", ".", ".", ".", ".", ".", ".", ".", ".", ".", "P"]
                   ],
    "MovingWumpusMode": true
    
}