{
    "Size": 8,
    "WorldMatrix": [["G", ".", "P", "P", ".", ".", ".", "."],
                    [".", ".", ".", ".", ".", ".", "P", "."],
                    [".", "P", "P", ".", ".", ".", ".", "."],
                    [".", ".", ".", ".", "P", ".", ".", "."],
                    [".", "P", ".", ".", ".", ".", "W", "."],
                    [".", "W", "P", ".", ".", ".", "P", "."],
                    [".", ".", ".", "P", ".", ".", ".", "."],
                    [".", ".", ".", ".", ".", ".", ".", "."]],
    "MovingWumpusMode": false
}