{
  "Size": 8,
  "WorldMatrix": [
    [".", ".", ".", "W", ".", ".", ".", "."],
    [".", ".", ".", ".", ".", "P", ".", "."],
    [".", ".", ".", ".", ".", ".", ".", "."],
    [".", ".", "P", ".", ".", "P", "P", "."],
    [".", ".", "P", "P", ".", ".", "P", "P"],
    [".", ".", ".", ".", ".", ".", ".", "P"],
    [".", ".", "P", ".", "W", "P", "P", "."],
    [".", ".", ".", "G", ".", ".", "P", "."]
  ],
  "MovingWumpusMode": false
}