[
  ['.', '.', '.', '.', '.', '.', '.', '.'],
  ['.', '.', '.', '.', '.', 'W', '.', '.'],
  ['.', '.', '.', '.', '.', '.', '.', '.'],
  ['.', '.', '.', 'W', '.', 'W', '.', '.'],
  ['.', '.', '.', '.', '.', '.', '.', '.'],
  ['.', '.', 'P', '.', '.', '.', 'P', '.'],
  ['.', '.', '.', '.', '.', '.', '.', '.'],
  ['<', '.', '.', '.', '.', '.', '.', '.']
]