[
  ['.', '.', '.', '.', '.', '.', '.', '.'],
  ['.', '.', '.', '.', '.', 'P', '.', '.'],
  ['.', '.', '.', '.', '.', '.', '.', '.'],
  ['.', '.', 'P', '.', '.', 'P', 'P', '.'],
  ['.', '.', 'P', 'P', '.', '.', 'P', 'v'],
  ['.', '.', '.', '.', '.', '.', '.', 'P'],
  ['.', '.', 'P', '.', 'W', 'P', 'P', '.'],
  ['.', '.', '.', 'G', '.', '.', 'P', '.']
]