[
  ['.', '.', '.', 'P', '.', '.', '.', '.', '.', '.', 'P', '.', '.', '.', 'P'],
  ['.', '.', '.', '.', '.', '.', '.', '.', '.', '.', '.', '.', 'W', '.', '.'],
  ['.', '.', '.', '.', '.', '.', '.', '.', '.', '.', '.', '.', '.', '.', '.'],
  ['P', '.', '.', '.', '.', '.', 'P', '.', '.', '.', 'P', '.', '.', '.', '.'],
  ['.', '.', '.', '.', '.', '.', '.', '.', '.', '.', '.', '.', '.', '.', '.'],
  ['.', '.', '.', '.', '.', '.', '.', '.', '.', '.', '.', '.', '.', '.', '.'],
  ['.', '>', '.', '.', '.', '.', '.', 'G', '.', '.', '.', 'P', '.', '.', '.'],
  ['.', '.', '.', 'P', '.', '.', '.', '.', '.', '.', '.', '.', '.', '.', 'P'],
  ['.', '.', '.', '.', '.', '.', '.', '.', '.', '.', '.', '.', '.', '.', '.'],
  ['.', '.', '.', '.', '.', '.', '.', '.', '.', '.', '.', '.', '.', '.', '.'],
  ['P', '.', 'P', '.', '.', '.', '.', '.', '.', '.', '.', '.', '.', '.', '.'],
  ['.', '.', '.', '.', '.', '.', '.', '.', '.', '.', '.', '.', '.', '.', '.'],
  ['.', '.', '.', '.', '.', '.', '.', '.', '.', '.', '.', '.', '.', '.', '.'],
  ['.', '.', '.', '.', '.', '.', 'W', '.', 'P', '.', '.', 'W', 'P', '.', '.'],
  ['.', '.', '.', '.', '.', '.', '.', '.', '.', '.', '.', '.', '.', '.', 'P']
]