[
  ['G', '.', 'P', 'P', '.', '.', '.', '.'],
  ['.', '.', '.', '.', '.', '.', 'P', '.'],
  ['.', 'P', 'P', '.', '.', '.', '.', '.'],
  ['.', '.', '.', '.', 'P', '.', '.', '.'],
  ['.', 'P', '.', '.', '.', '.', 'W', '.'],
  ['.', 'W', '^', '.', '.', '.', 'P', '.'],
  ['.', '.', '.', 'P', '.', '.', '.', '.'],
  ['.', '.', '.', '.', '.', '.', '.', '.']
]